####################################################################################################################
#__________________________________________________________________________________________________________________#
#__________________________________________________________________________________________________________________#
#__________________________________________________________________________________________________________________#
#__________________________________________________________________________________________________________________#
#__________________________________________________________________________________________________________________#
#__________________________________________________________________________________________________________________#
#__________________________________________________________________________________________________________________#
#__________________________________________________________________________________________________________________#
#__________________________________________________________________________________________________________________#
#__________________________________________________________________________________________________________________#
#__________________________________________________________________________________________________________________#
#__________________________________________________________________________________________________________________#
#__________________________________________________________________________________________________________________#
#__________________________________________________________________________________________________________________#
#__________________________________________________________________________________________________________________#
#__________________________________________________________________________________________________________________#
#__________________________________________________________________________________________________________________#
#________________________________________________________________@_________________________________________________#
#__________________________________________________________________________________________________________________#
#__________________________________________________________________________________________________________________#
#__________________________________________________________________________________________________________________#
#__________________________________________________________________________________________________________________#
#__________________________________________________________________________________________________________________#
#__________________________________________________________________________________________________________________#
#__________________________________________________________________________________________________________________#
#__________________________________________________________________________________________________________________#
#__________________________________________________________________________________________________________________#
#__________________________________________________________________________________________________________________#
####################################################################################################################