##########################################################
#@_______________________________________________________#
#________________________________________________________#
#________________________________________________________#
#________________________________________________________#
#________________________________________________________#
#________________________________________________________#
#________________________________________________________#
#________________________________________________________#
#________________________________________________________#
#________________________________________________________#
#________________________________________________________#
#________________________________________________________#
#________________________________________________________#
##########################################################