####################################################################################################################
#__________________________________________________________________________________________________________________#
#___@______________________________________________________________________________________________________________#
#__________________________________________________________________________________________________________________#
#__________________________________________________________________________________________________________________#
#__________________________________________________________________________________________________________________#
#__________________________________________________________________________________________________________________#
#__________________________________________________________________________________________________________________#
#__________________________________________________________________________________________________________________#
#__________________________________________________________________________________________________________________#
#__________________________________________________________________________________________________________________#
#__________________________________________________________________________________________________________________#
#__________________________________________________________________________________________________________________#
#__________________________________________________________________________________________________________________#
####################################################################################################################