##################################################
#@_______________________________________________#
#________________________________________________#
#________________________________________________#
##############################___________________#
#________________________________________________#
#________________________________________________#
#______g_________________________________________#
#________________________________________________#
#________________________________________________#
#########################_########################
                        #_#
                        #_#
                        #_#
                        #_#
                        #_#
                        #_#
#########################_########################
#________________________________________________#
#________________________________________________#
#_________________________________________g______#
#________________________________________________#
#_______________##################################
#________________________________________________#
#________________________________________________#
#________________________________________________#
#_______________________________________________s#
##################################################       